TILEMAP
50 10 							-- Size of tile map in tiles
16 32 							-- Tile size & block size
images/blocks.png 	-- Tilesheet
2 2 	
11111111111111111111111111111111111111111111111111
1                                  11111         1
1       11111         111                        1
1       11111         1111111                    1
1       11111         1111111      11111         1
1       11111         1111111      11111         1
1       11111         1111111      11111         1
1                     111          11111         1
1                                  11111         1
11111111111111111111111111111111111111111111111111